NO ./textures/wall_1.xpm
SO ./textures/wall_2.xpm
WE ./textures/wall_3.xpm
EA ./textures/wall_4.xpm
F 220,100,0
C 225,30,0


1111111111
1000000000
10000S0000
1111111111
