NO ./textures/wall_1.xpm
SO ./textures/wall_2.xpm
WE ./textures/wall_3.xpm
EA ./textures/wall_4.xpm
F 220,100,0
C 225,30,0
111111111111
100N01000001
100000010001
100000000001
111111111111
