NO ./textures/wall_1.xpm
SO ./textures/wall_2.xpm
WE ./textures/wall_3.xpm
EA ./textures/wall_4.xpm
F 220,100,0
C 235,20,0
111111111111111111
100101000000000001
100101000000000001
100101000000011111
100000000N00000001
100000000000011111
111111111111111111
